00000000000000000000000000000000000000000000000000000000000000000000000000000000000000000
00000000000000000000000000000000000000000000000000000000000000000000002222200000000000000
00000000040000000000000000000000000000000000000000000000000000000000000000000000000000000
00000000030000000000000000000000000000000000000000000000000222220000000000000000000000000
00000002222200000000000000000000000000000000000002220000000000000000000000000000000000000
00000000000000000000000000000000000000000000000000000000000000000000000000000000000000000
22000000000000000220000000000000000000000000000000000022220000000002222220000200022222220
11222222222222222112200000000222000002200000002222222211112200000221111110002100211111110
11111111111111111111100000000111000011110000001111111111111100000111111110001100111111110
11111111111111111111100011000000000000000000001111111111111110000111111110001100111111110
11111111111111111111100000000000000000000000001111111111111110001111111111001100111111110
11111111111111111111100000000000000100000010000111111111111111000111111111100110011111111
